лл     ллллл л       л ллллл лл   
лл     лл     л     л  лл    лл   
лл     ллллл   л   л   ллллл лл   
лл     лл       л л    лл    лл   
лллллл ллллл     л     ллллл ллллл
